3,3,3,3,3,3,3,3,3,3,3,3,3,3,3,3,3,3,3,3,-
3,1,1,1,1,1,1,1,1,1,1,1,1,1,3,6,1,1,1,3,-
3,1,1,1,1,1,1,1,1,1,1,1,1,1,1,1,1,1,7,3,-
3,1,1,3,3,1,1,1,1,1,1,1,1,1,1,3,3,3,3,3,-
3,1,1,3,1,3,1,1,1,1,1,1,3,3,3,1,1,1,1,3,-
3,1,1,3,1,3,1,1,1,1,1,1,3,3,3,1,1,1,1,3,-
3,1,1,1,1,3,3,1,1,1,1,1,3,1,1,1,1,1,1,3,-
3,1,1,1,1,1,1,1,1,1,1,1,3,3,1,1,1,1,1,3,-
3,1,7,1,3,3,1,1,1,1,1,3,3,3,3,3,1,1,1,3,-
3,3,3,1,1,3,1,1,1,1,3,3,1,1,1,1,1,1,1,3,-
3,1,3,1,1,1,3,1,1,1,3,1,1,1,1,1,1,1,1,3,-
3,1,1,3,3,3,1,1,1,1,3,1,1,1,3,1,1,1,1,3,-
3,1,1,1,1,1,1,1,1,1,1,3,3,3,3,1,1,1,8,3,-
3,1,1,1,1,1,1,1,1,1,1,1,1,1,1,1,1,1,1,3,-
3,1,1,1,1,1,1,1,7,3,1,1,1,1,1,1,1,1,1,3,-
3,3,3,3,3,3,3,3,3,3,3,3,3,3,3,3,3,3,3,3