3,3,3,3,3,3,3,3,3,3,3,3,3,3,3,3,3,3,3,3,-
3,7,1,1,1,3,1,6,1,1,1,1,3,1,1,1,1,1,1,3,-
3,1,1,1,1,3,3,1,3,3,3,1,3,3,1,1,1,1,1,3,-
3,3,1,1,1,1,3,1,1,3,3,1,1,1,3,1,1,1,1,3,-
3,3,1,1,4,1,1,1,1,1,1,1,1,1,1,1,3,1,1,3,-
3,3,1,3,1,1,3,1,3,3,1,1,1,1,1,3,1,1,3,3,-
3,3,1,3,1,3,3,1,1,3,1,3,1,1,3,3,1,3,1,3,-
3,3,1,1,1,1,1,1,1,1,1,1,1,1,3,7,1,1,1,3,-
3,1,1,3,3,1,1,1,1,7,1,1,1,1,1,1,3,3,3,3,-
3,1,1,1,3,3,1,3,3,1,1,1,3,3,3,3,3,1,1,3,-
3,1,1,1,1,3,1,1,3,1,1,1,3,3,3,1,1,1,1,3,-
3,1,1,1,1,1,3,1,1,1,1,3,3,3,3,8,1,1,1,3,-
3,1,3,3,1,1,1,3,1,1,1,1,1,1,3,1,1,1,1,3,-
3,1,1,1,3,3,3,1,1,1,1,1,1,1,3,1,1,1,1,3,-
3,1,1,1,1,1,1,1,1,1,4,1,1,1,1,1,1,1,1,3,-
3,3,3,3,3,3,3,3,3,3,3,3,3,3,3,3,3,3,3,3