3,3,3,3,3,3,3,3,3,3,3,3,3,3,3,3,3,3,3,3,-
3,8,3,2,1,1,1,1,1,1,1,1,1,1,1,1,1,1,1,3,-
3,1,3,2,1,1,3,1,1,1,1,1,1,1,1,4,1,1,1,3,-
3,1,1,2,1,1,1,1,1,1,1,1,1,1,1,1,1,1,1,3,-
3,1,1,2,1,1,1,1,1,1,1,1,1,1,1,1,1,1,1,3,-
3,1,1,2,1,1,1,1,1,1,3,1,1,1,3,1,4,1,1,3,-
3,1,7,1,1,1,1,1,1,1,1,3,1,3,2,3,1,1,3,3,-
3,1,1,3,1,1,1,1,1,3,1,1,3,1,1,3,1,1,1,3,-
3,4,1,1,1,1,1,1,1,3,1,1,1,1,1,3,1,1,1,3,-
3,1,1,1,1,1,1,1,4,1,3,2,1,1,3,1,1,1,1,3,-
3,1,1,1,1,1,1,3,1,1,1,3,7,3,1,1,3,1,1,3,-
3,1,1,3,1,1,1,3,1,1,1,1,3,1,1,1,3,1,1,3,-
3,1,3,1,1,3,1,1,1,1,1,1,1,1,1,1,3,3,3,3,-
3,1,1,1,3,1,1,3,1,3,1,1,1,1,1,1,1,1,1,3,-
3,1,1,3,7,1,2,3,1,1,1,1,1,1,1,1,1,1,6,3,-
3,3,3,3,3,3,3,3,3,3,3,3,3,3,3,3,3,3,3,3